Você é um escravo do tempo da Roma Antiga. Você sempre escutou estórias emocionantes sobre os jogos gladiatoriais contadas pelo seu mestre, que é um ávido frequentador do grandioso Coliseu de Roma. Portanto, seu sonho maior é assistir pelo menos uma vez um desses combates épicos.

Agora você se encontra no Jardim de seu mestre, cuidando de suas gladioli. Você deve agora podar algumas de suas folhas. Você pode ver a entrada para a casa do seu mestre a oeste.

Welcome
An Interactive Fiction
Release 1 / Serial number 101221 / Inform 7 build 6F95 (I6/v6.31 lib 6/12N) SD

Jardim
You can see a Gladioli here.

>items
That's not a verb I recognise.

>inventary
That's not a verb I recognise.

>inventory
You are carrying nothing.

* * *

>examine Felix
You can't see any such thing.

* * *

>examine me
Você⼅ é um escravo do tempo da Roma Antiga. Você sempre escutou estórias emocionantes sobre os jogos gladiatoriais contadas pelo seu mestre, que é um áuvido frequentador do grandioso Coliseu de Roma. Portanto, seu sonho maior é assistir pelo menos uma vez um desses combates épicos. Agora voc

>examine Gladioli
Flores de fá⼅cil crescimento, especialmente usadas em arranjos florais. Gladioli produzem espinhos altos com muitas flores, formando um arco-íris de cores.

>prune Gladioli
Você⼅ poda perfeitamente a gladioli do jardim de seu mestre. Assim que você termina seu trabalho você observa uma pessoa se aproximando.

Felix: Nosso senhor deseja vê-lo, ele o está esperando no Tablinum. Vá logo antes que seja punido.

A pessoa é um dos escravos de seu mestre, ele se chama Felix, e dirige a palavra a você.tr

>go west
Entrada dos fundos

>i
You are carrying:
  a Chave para a casa de seu mestre
  a Tesoura para poda

>examine Chave
Uma pequena chave de cobre usada na entrada dos fundos da casa de seu mestre, Aulus Petronius Cicero

>go north
Peristilo

>examine Tesoura
Tesoura de ferro usada pelos escravos para podar as plantas do jardim de seu mestre.

>go west
Tablinum

>examine Aulus
You can't see any such thing.

>go east
Peristilo

>go west
Tablinum

>go east
Peristilo

>wait
Time passes.

>wait
Time passes.

>wait
    *** Você demorou muito para cumprir o chamado de seu mestre, isso é uma ofensa grave, e você irái ser castigado e preso durante duas semanas. ***

In that game you scored 0 out of a possible 0, in 21 turns.

Would you like to RESTART, RESTORE a saved game, QUIT or UNDO the last command?

* * *

>go west
Você⼅ deve terminar seu trabalho no jardim.

>prune gladioli
Você⼅ poda perfeitamente a gladioli do jardim de seu mestre. Assim que você termina seu trabalho você observa uma pessoa se aproximando.

A pessoa é um dos escravos de seu mestre, ele se chama Felix, e dirige a palavra a você..

Felix: Nosso senhor deseja vê-lo, ele o está esperando no Tablinum. Vá logo antes que seja punidovoc

>go west
Entrada dos fundos
You can see a Porta dos fundos here.

>go north
(first opening the Porta dos fundos)
It seems to be locked.

>unlock Porta with Chave
You unlock the Porta dos fundos.

>go north
(first opening the Porta dos fundos)

Peristilo
You can see a Porta dos fundos here.

>examine me
Você⼅ é um escravo do tempo da Roma Antiga. Você sempre escutou estórias emocionantes sobre os jogos gladiatoriais contadas pelo seu mestre, que é um áuvido frequentador do grandioso Coliseu de Roma. Portanto, seu sonho maior é assistir pelo menos uma vez um desses combates épicos.謠ᛏ鷠ᛏ麐ᛏ놠ᛏ뉐ᛏ

>examine i
You can't see any such thing.

>i
You are carrying:
  a Chave para a casa de seu mestre
  a Tesoura para poda

* * *

>go west
Você⼅ deve terminar seu trabalho no jardim.

>go jardim
You can't see any such thing.

>go east
Jardim
Vocêo é um escravo do tempo da Roma Antiga. Você sempre escutou estórias emocionantes sobre os jogos gladiatoriais contadas pelo seu mestre, que é um áuvido frequentador do grandioso Coliseu de Roma. Portanto, seu sonho maior é assistir pelo menos uma vez um desses combates épicos. Agora você se encontra no Jardim de seu mestre, cuidando de suas petúnias.

* * *

>go west
Você⼅ deve terminar seu trabalho no jardim.

>open gladioli
That's not something you can open.

>cut gladioli
Cutting that up would achieve little.

* * *

>go jardim
You can't see any such thing.

>go north
Caminho para a casa de Gaius

>go south
Jardim
Vocêo é um escravo do tempo da Roma Antiga. Você sempre escutou estórias emocionantes sobre os jogos gladiatoriais contadas pelo seu mestre, que é um áuvido frequentador do grandioso Coliseu de Roma. Portanto, seu sonho maior é assistir pelo menos uma vez um desses combates épicos. Agora você se encontra no Jardim de seu mestre, cuidando de suas petúnias.

* * *

>use Tesoura
That's not a verb I recognise.

>use Tesoura on Gladioli
That's not a verb I recognise.

>look Jardim
You can't see any such thing.

>look Gladioli
Flores de fá⼅cil crescimento, especialmente usadas em arranjos florais. Gladioli produzem espinhos altos com muitas flores, formando um arco-íris de cores.

>look Tesoura
Tesoura de ferro usada pelos eschravos para podar as plantas do jardim de seu mestre.

* * *

>go street
You can't see any such thing.

>go Streets of Ancient Rome
You can't see any such thing.

* * *

>prune Gladioli
Você⼅ poda perfeitamente a gladioli do jardim de seu mestre. Assim que você termina seu trabalho você observa uma pessoa se aproximando.

>cut Gladioli
Você⼅ poda perfeitamente a gladioli do jardim de seu mestre. Assim que você termina seu trabalho você observa uma pessoa se aproximando.

* * *

>cut gladioli
Você⼅ poda perfeitamente a gladioli do jardim de seu mestre. Assim que você termina seu trabalho você observa uma pessoa se aproximando.

>cut gladioli with tesoura
I only understood you as far as wanting to cut the Gladioli.

* * *

>cut gladioli
Você⼅ poda perfeitamente a gladioli do jardim de seu mestre. Assim que você termina seu trabalho você observa uma pessoa se aproximando.

>look Felix
Um dos escravos de seu senhor.

>examine Jardim
You can't see any such thing.

>examine Felix
Um dos escravos de seu senhor.

* * *

>examine
What do you want to examine?

>examine me
Você é um escravo do tempo da Roma Antiga. Você sempre escutou estórias emocionantes sobre os jogos gladiatoriais contadas pelo seu mestre, que é um ávido frequentador do grandioso Coliseu de Roma. Portanto, seu sonho maior é assistir pelo menos uma vez um desses combates épicos.

>examine gladioli
Flores de fácil crescimento, especialmente usadas em arranjos florais. Gladioli produzem espinhos altos com muitas flores, formando um arco-íris de cores.

>i
You are carrying:
  a Chave para a casa de seu mestre
  a Tesoura para poda

>prune gladioli
Você poda perfeitamente a gladioli do jardim de seu mestre. Assim que você termina seu trabalho você observa uma pessoa se aproximando.

A pessoa é um dos escravos de seu mestre, ele se chama Felix, e dirige a palavra a você.

Felix: Nosso senhor deseja vê-lo, ele o está esperando no Tablinum. Vá logo antes que seja punido.
Você pode ver a porta dos fundos a oeste.

>go west
Entrada dos fundos
Você está na entrada dos fundos da casa de seu mestre, normalmente usada por seus escravos. Você pode ver uma porta para o peristilo ao norte. Você pode ver também uma casa parecida com a de seu senhor a oeste.

You can see a Porta dos fundos here.

>go west
Você não recebeu ordens para se afastar da casa de seu senhor.

>unlock porta with chave
You unlock the Porta dos fundos.

>go north
(first opening the Porta dos fundos)

Peristilo
O Peristilo é a um corredor coberto e circundante, aberto lateralmente através de uma ou mais fiadas de colunas. O tablinum se encontra a oeste.

You can see a Porta dos fundos here.

>go west
Tablinum
Os muros do tablinum são decorados com pinturas, e bustos da família de seu mestre estão dispostos nos dois lados do quarto. O tablinum serve de escritório, e é onde o seu mestre recebe os seus clientes.

You can see an Aulus Petronius Cicero here.

Seu senhor se encontra na escrivaninha, assinando vários pergaminhos. Logo que você chega ao tablinum, ele se dirige a você, com um pedaço de pergaminho na mão, e diz:"Escravo, tenho uma tarefa especial para você. Pegue esse pergaminho e entregue para meu amigo Gaius, que mora ao norte daqui. Use a saída dos fundos."

>go east
Peristilo
O Peristilo é a um corredor coberto e circundante, aberto lateralmente através de uma ou mais fiadas de colunas. O tablinum se encontra a oeste.

You can see a Porta dos fundos here.

>go south
Entrada dos fundos
Você está na entrada dos fundos da casa de seu mestre, normalmente usada por seus escravos. Você pode ver uma porta para o peristilo ao norte. Você pode ver também uma casa parecida com a de seu senhor a oeste.

You can see a Porta dos fundos here.

>go west
Caminho para a casa de Gaius
caminho que leva a casa de Gaius, o amigo do mestre a quem você deverá entregar o ingresso, tambem leva a estrada principal com destino a cidade de Roma onde se localiza o Coliseum.

You can see Adora Kaab here.

Você se aproxima da mulher e pergunta: qual é o seu nome.
Adora Kaab olha para você, mas nao responde nada e segue seu caminho.

>go west
Caminho para Roma
Caminho percorrido por você até o Coliseum.

You can see a Coliseum here.

* * *

>cut the Gladioli with the Tesoura
I only understood you as far as wanting to cut the Gladioli.

>cut the Gladioli with Tesoura
I only understood you as far as wanting to cut the Gladioli.

* * *

>what is gladioli
That's not a verb I recognise.

>look the gladioli
I only understood you as far as wanting to look.

>go the west
Você⼅ deve terminar seu trabalho no jardim.

>prune the gladioli which the tesoura
I only understood you as far as wanting to prune the Gladioli.

>west the peristilo
I only understood you as far as wanting to west the Gladioli.

>Chave
That's not a verb I recognise.

>description the chave
That's not a verb I recognise.

>what's chave
That's not a verb I recognise.

>carry a Chave
You already have that.

>yes
That was a rhetorical question.

>Peristilo
That's not a verb I recognise.

>room
That's not a verb I recognise.

>verb I recognise.
That's not a verb I recognise.

>felix prune the gladioli which the tesoura
That's not a verb I recognise.

* * *

>go south
You can't go that way.

>go west
Entrada dos fundos

* * *

>go north
Coliseum of Ancient Rome
You walk into the Coliseum as its gates are opening before you.

>go south
Streets of Ancient Rome
You can see You and Runaway Gladiator here.

>go Coliseum of Ancient Rome
You can't see any such thing.

>go north
Coliseum of Ancient Rome

* * *

>go Coliseum
You can't see any such thing.

>go north
Coliseum of Ancient Rome

* * *

>i
You are carrying:
  a Chave para a casa de seu mestre

>look Chave
Uma pequena chave de cobre usada na entrada dos fundos da casa de seu mestre, Aulus Petronius Cicero

* * *

>prune gladioli
Você poda perfeitamente a gladioli do jardim de seu mestre. Assim que você termina seu trabalho você observa uma pessoa se aproximando.

A pessoa é um dos escravos de seu mestre, ele se chama Felix, e dirige a palavra a você.

Felix: Nosso senhor deseja vê-lo, ele o está esperando no Tablinum. Vá logo antes que seja punido.
Você pode ver a porta dos fundos a oeste.

>go east
You can't go that way.

>look
Jardim
You can see a Felix and a Gladioli here.

>go west
Entrada dos fundos
Você está na entrada dos fundos da casa de seu mestre, normalmente usada por seus escravos. Você pode ver uma porta para o peristilo ao norte.

You can see a Porta dos fundos here.

* * *

>prune gladioli
Você poda perfeitamente a gladioli do jardim de seu mestre. Assim que você termina seu trabalho você observa uma pessoa se aproximando.

A pessoa é um dos escravos de seu mestre, ele se chama Felix, e dirige a palavra a você.

Felix: Nosso senhor deseja vê-lo, ele o está esperando no Tablinum. Vá logo antes que seja punido.
Você pode ver a porta dos fundos a oeste.

>go west
Entrada dos fundos
Você está na entrada dos fundos da casa de seu mestre, normalmente usada por seus escravos. Você pode ver uma porta para o peristilo ao norte.

You can see a Porta dos fundos here.

>go north
(first opening the Porta dos fundos)
It seems to be locked.

>unlock porta with chave
You unlock the Porta dos fundos.

* * *

>go east
Peristilo
O Peristilo é a um corredor coberto e circundante, aberto lateralmente através de uma ou mais fiadas de colunas. O tablinum se encontra a oeste.

You can see a Porta dos fundos here.

>go west
Tablinum
Os muros do tablinum são decorados com pinturas, e bustos da família de seu mestre estão dispostos nos dois lados do quarto. O tablinum serve de escritório, e é onde o seu mestre recebe os seus clientes.

You can see an Aulus Petronius Cicero here.

>go west
You can't go that way.

>go east
Peristilo
O Peristilo é a um corredor coberto e circundante, aberto lateralmente através de uma ou mais fiadas de colunas. O tablinum se encontra a oeste.

You can see a Porta dos fundos here.

>go south
Entrada dos fundos
Você está na entrada dos fundos da casa de seu mestre, normalmente usada por seus escravos. Você pode ver uma porta para o peristilo ao norte.

You can see a Porta dos fundos here.

>go south
You can't go that way.

>go north
Peristilo
O Peristilo é a um corredor coberto e circundante, aberto lateralmente através de uma ou mais fiadas de colunas. O tablinum se encontra a oeste.

You can see a Porta dos fundos here.

>go south
Entrada dos fundos
Você está na entrada dos fundos da casa de seu mestre, normalmente usada por seus escravos. Você pode ver uma porta para o peristilo ao norte.

You can see a Porta dos fundos here.

>go west
You can't go that way.

>go east
Jardim
You can see a Felix and a Gladioli here.

>go north
Caminho para a casa de Gaius
caminho que leva a casa de Gaius, o amigo do mestre a quem  felix devera entregar o ingresso, tambem leva a estrada principal com destino a cidade de Roma onde se localiza o Coliseum.

You can see Adora Kaab here.

Você se aproxima da mulher e pergunta: qual é o seu nome.
Adora Kaab olha para felix, mas nao responde nada e segue seu caminho.