Você é um escravo do tempo da Roma Antiga. Você sempre escutou estórias emocionantes sobre os jogos gladiatoriais contadas pelo seu mestre, que é um ávido frequentador do grandioso Coliseu de Roma. Portanto, seu sonho maior é assistir pelo menos uma vez um desses combates épicos.

Agora você se encontra no Jardim de seu mestre, cuidando de suas gladioli. Você deve agora podar algumas de suas folhas. Você pode ver a entrada para a casa do seu mestre a oeste.

Welcome
An Interactive Fiction
Release 1 / Serial number 101216 / Inform 7 build 6F95 (I6/v6.31 lib 6/12N) SD

Jardim
You can see a Gladioli here.

>use Tesoura
That's not a verb I recognise.

>use Tesoura on Gladioli
That's not a verb I recognise.

>look Jardim
You can't see any such thing.

>look Gladioli
Flores de fácil crescimento, especialmente usadas em arranjos florais. Gladioli produzem espinhos altos com muitas flores, formando um arco-íris de cores.

>look Tesoura
Tesoura de ferro usada pelos eschravos para podar as plantas do jardim de seu mestre.

* * *

>cut gladioli
Você poda perfeitamente a gladioli do jardim de seu mestre. Assim que você termina seu trabalho você observa uma pessoa se aproximando.

>cut gladioli with tesoura
I only understood you as far as wanting to cut the Gladioli.

* * *

>cut gladioli
Você poda perfeitamente a gladioli do jardim de seu mestre. Assim que você termina seu trabalho você observa uma pessoa se aproximando.

>look Felix
Um dos escravos de seu senhor.

>examine Jardim
You can't see any such thing.

>examine Felix
Um dos escravos de seu senhor.

* * *

>prune Gladioli
Você poda perfeitamente a gladioli do jardim de seu mestre. Assim que você termina seu trabalho você observa uma pessoa se aproximando.

>cut Gladioli
Você poda perfeitamente a gladioli do jardim de seu mestre. Assim que você termina seu trabalho você observa uma pessoa se aproximando.

* * *

>examine Felix
You can't see any such thing.

* * *

>examine me
Você é um escravo do tempo da Roma Antiga. Você sempre escutou estórias emocionantes sobre os jogos gladiatoriais contadas pelo seu mestre, que é um ávido frequentador do grandioso Coliseu de Roma. Portanto, seu sonho maior é assistir pelo menos uma vez um desses combates épicos.

>examine Gladioli
Flores de fácil crescimento, especialmente usadas em arranjos florais. Gladioli produzem espinhos altos com muitas flores, formando um arco-íris de cores.

>prune Gladioli
Você poda perfeitamente a gladioli do jardim de seu mestre. Assim que você termina seu trabalho você observa uma pessoa se aproximando.

Felix: Nosso senhor deseja vê-lo, ele o está esperando no Tablinum. Vá logo antes que seja punido.

A pessoa é um dos escravos de seu mestre, ele se chama Felix, e dirige a palavra a você.

>go west
Entrada dos fundos

>i
You are carrying:
  a Chave para a casa de seu mestre
  a Tesoura para poda

>examine Chave
Uma pequena chave de cobre usada na entrada dos fundos da casa de seu mestre, Aulus Petronius Cicero

>go north
Peristilo

>examine Tesoura
Tesoura de ferro usada pelos escravos para podar as plantas do jardim de seu mestre.

>go west
Tablinum

>examine Aulus
You can't see any such thing.

>go east
Peristilo

>go west
Tablinum

>go east
Peristilo

>wait
Time passes.

>wait
Time passes.

>wait
    *** Você demorou muito para cumprir o chamado de seu mestre, isso é uma ofensa grave, e você irá ser castigado e preso durante duas semanas. ***

In that game you scored 0 out of a possible 0, in 21 turns.

Would you like to RESTART, RESTORE a saved game, QUIT or UNDO the last command?

* * *

>hi
That's not a verb I recognise.

* * *

>i
You are carrying:
  a Chave para a casa de seu mestre

>look Chave
Uma pequena chave de cobre usada na entrada dos fundos da casa de seu mestre, Aulus Petronius Cicero

* * *

>go west
Você deve terminar seu trabalho no jardim.

>prune gladioli
Você poda perfeitamente a gladioli do jardim de seu mestre. Assim que você termina seu trabalho você observa uma pessoa se aproximando.

A pessoa é um dos escravos de seu mestre, ele se chama Felix, e dirige a palavra a você..

Felix: Nosso senhor deseja vê-lo, ele o está esperando no Tablinum. Vá logo antes que seja punido

>go west
Entrada dos fundos
You can see a Porta dos fundos here.

>go north
(first opening the Porta dos fundos)
It seems to be locked.

>unlock Porta with Chave
You unlock the Porta dos fundos.

>go north
(first opening the Porta dos fundos)

Peristilo
You can see a Porta dos fundos here.

>examine me
Você é um escravo do tempo da Roma Antiga. Você sempre escutou estórias emocionantes sobre os jogos gladiatoriais contadas pelo seu mestre, que é um ávido frequentador do grandioso Coliseu de Roma. Portanto, seu sonho maior é assistir pelo menos uma vez um desses combates épicos.

>examine i
You can't see any such thing.

>i
You are carrying:
  a Chave para a casa de seu mestre
  a Tesoura para poda

* * *

>go west
Você deve terminar seu trabalho no jardim.

>go jardim
You can't see any such thing.

>go east
Jardim
Você é um escravo do tempo da Roma Antiga. Você sempre escutou estórias emocionantes sobre os jogos gladiatoriais contadas pelo seu mestre, que é um ávido frequentador do grandioso Coliseu de Roma. Portanto, seu sonho maior é assistir pelo menos uma vez um desses combates épicos. Agora você se encontra no Jardim de seu mestre, cuidando de suas petúnias.

* * *

>go west
Você deve terminar seu trabalho no jardim.

>open gladioli
That's not something you can open.

>cut gladioli
Cutting that up would achieve little.

* * *

>go jardim
You can't see any such thing.

>go north
Caminho para a casa de Gaius

>go south
Jardim
Você é um escravo do tempo da Roma Antiga. Você sempre escutou estórias emocionantes sobre os jogos gladiatoriais contadas pelo seu mestre, que é um ávido frequentador do grandioso Coliseu de Roma. Portanto, seu sonho maior é assistir pelo menos uma vez um desses combates épicos. Agora você se encontra no Jardim de seu mestre, cuidando de suas petúnias.

* * *

>go Coliseum
You can't see any such thing.

>go north
Coliseum of Ancient Rome

* * *

>go north
Coliseum of Ancient Rome
You walk into the Coliseum as its gates are opening before you.

>go south
Streets of Ancient Rome
You can see You and Runaway Gladiator here.

>go Coliseum of Ancient Rome
You can't see any such thing.

>go north
Coliseum of Ancient Rome

* * *

>see ticket
That's not a verb I recognise.

>move runaway gladiator
That would be less than courteous.

* * *

>go street
You can't see any such thing.

>go Streets of Ancient Rome
You can't see any such thing.

* * *

>take gladius
You can't see any such thing.

* * *

>items
That's not a verb I recognise.

>inventary
That's not a verb I recognise.

>inventory
You are carrying nothing.

* * *

>cut the Gladioli with the Tesoura
I only understood you as far as wanting to cut the Gladioli.

>cut the Gladioli with Tesoura
I only understood you as far as wanting to cut the Gladioli.

* * *

>go south
You can't go that way.

>go west
Entrada dos fundos