The ancient coliseum stands in front of you, calling you to enter its halls. The vicious sounds of battle echoes inside the arena, followed by the vigorous cheers of the audience. Do you want to enter?.

Welcome
An Interactive Fiction
Release 1 / Serial number 101116 / Inform 7 build 6F95 (I6/v6.31 lib 6/12N) SD

Streets of Ancient Rome
You can see You and Runaway Gladiator here.

>take gladius
You can't see any such thing.

* * *

The ancient coliseum stands in front of you, calling you to enter its halls. The vicious sounds of battle echoes inside the arena, followed by the vigorous cheers of the audience. Do you want to enter?.

Welcome
An Interactive Fiction
Release 1 / Serial number 101116 / Inform 7 build 6F95 (I6/v6.31 lib 6/12N) SD

Streets of Ancient Rome
You can see You and Runaway Gladiator here.

>hi
That's not a verb I recognise.

* * *

The ancient coliseum stands in front of you, calling you to enter its halls. The vicious sounds of battle echoes inside the arena, followed by the vigorous cheers of the audience. Do you want to enter?.

Welcome
An Interactive Fiction
Release 1 / Serial number 101116 / Inform 7 build 6F95 (I6/v6.31 lib 6/12N) SD

Streets of Ancient Rome
You can see You and Runaway Gladiator here.

>go north
Coliseum of Ancient Rome
You walk into the Coliseum as its gates are opening before you.

* * *

The ancient coliseum stands in front of you, calling you to enter its halls. The vicious sounds of battle echoes inside the arena, followed by the vigorous cheers of the audience. Do you want to enter?.

Welcome
An Interactive Fiction
Release 1 / Serial number 101116 / Inform 7 build 6F95 (I6/v6.31 lib 6/12N) SD

Streets of Ancient Rome
You can see You and Runaway Gladiator here.

>go Coliseum
You can't see any such thing.